2525252525252525252525252525252563636363636363636363636363636363050505050503050505050501030105050505010103010105050101010301010100000000000000000000000000000000000000000000000000000000000000000000000000000000000000000000000000000000000000000000000000000000
2525252525262725252525252526272562626262626262626262626262626262050505050501050505050505050505050505050501050505050105050105050100000000000000000000000000000000000000000000000000000000000000000000000000000000000000000000000000000000000000000000000000000000
2526362525252525252525262725252562626262626262626262626262626262050505050505050505050505050502050505050505050505050105050505050100000000000000000000000000000000000000000000000000000000000000000000000000000000000000000000000000000000000000000000000000000000
2525252525252525262725252525252562626262626262626262626262626262050505050501050505050501010105050505050501050505050502050501050500000000000000000000000000000000000000000000000000000000000000000000000000000000000000000000000000000000000000000000000000000000
2525262725252525252525252627252562626262626262626262626262626262050505020504050505050505040505050505050505050205050505010505050500000000000000000000000000000000000000000000000000000000000000000000000000000000000000000000000000000000000000000000000000000000
2525252525262725252526272525252542616161616161616161616161616143050505050505050505050505050505050501020105010205050502050101020500000000000000000000000000000000000000000000000000000000000000000000000000000000000000000000000000000000000000000000000000000000
2526272525252525252525252525252550000000000000000000000000000051050505050505050505050205050505050505050405050505010501050405050500000000000000000000000000000000000000000000000000000000000000000000000000000000000000000000000000000000000000000000000000000000
2525252525252627252525252526272550000000000000000000000000000051050505050505050505050505050505050505050505050505050505050505050500000000000000000000000000000000000000000000000000000000000000000000000000000000000000000000000000000000000000000000000000000000
2525252627252525252627252525252550000000000000000000000000000051010301010505050503050101010101010301010505050101010505050505030500000000000000000000000000000000000000000000000000000000000000000000000000000000000000000000000000000000000000000000000000000000
2525252525252525252525252525252550000000000000000000000000000051050101050505050505050505050505010101050502050504050202050205010500000000000000000000000000000000000000000000000000000000000000000000000000000000000000000000000000000000000000000000000000000000
2525252525252525252525252525252550000000000000000000000000000051050502050505050501050101050502050105010505050105050505020501050500000000000000000000000000000000000000000000000000000000000000000000000000000000000000000000000000000000000000000000000000000000
1717173514151534151515163717171750000000000000000000000000000051050105010505050501050101010505050105050105010505050505050501050500000000000000000000000000000000000000000000000000000000000000000000000000000000000000000000000000000000000000000000000000000000
1717351415151515151515151637171750000000000000000000000000000051050502050205050501050504050505050105010105010105010105050505050500000000000000000000000000000000000000000000000000000000000000000000000000000000000000000000000000000000000000000000000000000000
1735141515151534151515151516371750000000000000000000000000000051050105010501050501050505050505050105050505050505010101050105050500000000000000000000000000000000000000000000000000000000000000000000000000000000000000000000000000000000000000000000000000000000
3514151515151515151515151515163750000000000000000000000000000051050502050504050501050205050505050105050205020505050405050505050500000000000000000000000000000000000000000000000000000000000000000000000000000000000000000000000000000000000000000000000000000000
1415151515151534151515151515151652606060606060606060606060606053050505050505050501010505050505050105050505050505050505050505050500000000000000000000000000000000000000000000000000000000000000000000000000000000000000000000000000000000000000000000000000000000
