252525252525252525252525252525256363636363636363636363636363636305050505050305050505050103010505050501010301010505010101030101010000c4c5c4c5c4c5c4c5c4c5c4c5000000000000000000000000000000000000df030313038383232b57c3030303a303474763670703038303030b03434343ef
252525252526272525252525252627256262626262626262626262626262626205050505050105050505050505050505050505050105050505010505010505010000c6c7c6c7c6c7c6c7c6c7c6c70000000000000000000000000000000000005c000000008080202c54c0000000a100848480c04000008002020a02020202ae
252636252525252525252526272525256262626262626262626262626262626205050505050505050505050505050205050505050505050505010505050505010000f400f400f400f400f400f4000000000000000000000000000000000000005f434202020606064e54d0100002a3020626a2e37313118103030b0a020212be
25252525252525252627252525252525626262626262626262626262626262620505050505010505050505010101050505050505010505050505020505010505000000f500f500f500f500f500f50000000000000000000000000000000000005d110101010100000054c0400000a808042c84c4444040c0c2820a02020212be
252526272525252525252525262725256262626262626262626262626262626205050502050405050505050504050505050505050505020505050501050505050000f400f400f400f400f400f400000000000000000000000000000000000000d5818181010101010155c0400000a00a062a82c24242424242c24a42424242ee
25252525252627252525262725252525426161616161616161616161616161430505050505050505050505050505050505010201050102050505020501010205000000f500f500f500f500f500f50000000000000000000000000000000000005d0d09998181c1c14155c04040406008042890d05252424242820a02020202ae
252627252525252525252525252525255000000000000000000000000000005105050505050505050505020505050505050505040505050501050105040505050000f400f400f400f400f400f4000000000000000000000000000000000000005d4d09090101018101150000000020080428d0d01212020202020a02020202ae
25252525252526272525252525262725500000000000000000000000000000510505050505050505050505050505050505050505050505050505050505050505000000f500f500f500f500f500f5000000000000000000000000000000000000554501010101018111150000000020000428f0b01212120202020a02020202ae
252525262725252525262725252525255000000000000000000000000000005101030101050505050305010101010101030101050505010101050505050503050000f400f400f400f400f400f40000000000000000000000000000000000000055454501010121a1a1b1b0108080a08084a8f0b0121212020202020202020aae
25252525252525252525252525252525500000000000000000000000000000510501010505050505050505050505050101010505020505040502020502050105000000f500f500f500f500f500f500000000000000000000000000000000000055444010120202222231200000002048486860201252524202020202028292be
252525252525252525252525252525255000000000000000000000000000005105050205050505050105010105050205010501050505010505050502050105050000f400f400f400f400f400f40000000000000000000000000000000000000055444000000000000415240000002000002820201240404141010101018190be
17171735141515341515151637171717500000000000000000000000000000510501050105050505010501010105050501050501050105050505050505010505000000f500f500f500f500f500f5000000000000000000000000000000000000d5c4c040404000000011341010102206062e22220341414140000000008080ae
171735141515151515151515163717175000000000000000000000000000005105050205020505050105050405050505010501010501010501010505050505050000f400f400f400f400f400f40000000000000000000000000000000000000055514141416160405011240000002202062e26230341414140000000008080ae
17351415151515341515151515163717500000000000000000000000000000510501050105010505010505050505050501050505050505050101010501050505000000f500f500f500f500f500f500000000000000000000000000000000000055404040406160404011240000002202022e27232260606042020200008080ae
351415151515151515151515151516375000000000000000000000000000005105050205050405050105020505050505010505020502050505040505050505050000000000000000000000000000000000000000000000000000000000000000574242424263634242d3a20202023a12131b07060241416143030301018189ab
141515151515153415151515151515165260606060606060606060606060605305050505050505050101050505050505010505050505050505050505050505050000000000000000000000000000000000000000000000000000000000000000f5c0c0c0d0f0f0c0c2d1e1c1c0d0f8d0d1d9d8c4c5c1c0e0c2c2c2c0c0c0c0fa
