252525252525252525252525252525256363636363636363636363636363636305050505050305050505050103010505050501010301010505010101030101010000000000000000000000000000000000000000000000000000000000000000df030313038383232b57c3030303a303474763670703038303030b03434343ef
2525252525262725252525252526272562626262626262626262626262626262050505050501050505050505050505050505050501050505050105050105050100000000000000000000000000000000000000000000000000000000000000005c000000008080202c54c0000000a100848480c04000008002020a02020202ae
2526362525252525252525262725252562626262626262626262626262626262050505050505050505050505050502050505050505050505050105050505050100000000000000000000000000000000000000000000000000000000000000005f434202020606064e54d0100002a3020626a2e37313118103030b0a020212be
2525252525252525262725252525252562626262626262626262626262626262050505050501050505050501010105050505050501050505050502050501050500000000000000000000000000000000000000000000000000000000000000005d110101010100000054c0400000a808042c84c4444040c0c2820a02020212be
252526272525252525252525262725256262626262626262626262626262626205050502050405050505050504050505050505050505020505050501050505050000000000000000000000000000000000000000000000000000000000000000d5818181010101010155c0400000a00a062a82c24242424242c24a42424242ee
2525252525262725252526272525252542616161616161616161616161616143050505050505050505050505050505050501020105010205050502050101020500000000000000000000000000000000000000000000000000000000000000005d0d09998181c1c14155c04040406008042890d05252424242820a02020202ae
2526272525252525252525252525252550000000000000000000000000000051050505050505050505050205050505050505050405050505010501050405050500000000000000000000000000000000000000000000000000000000000000005d4d09090101018101150000000020080428d0d01212020202020a02020202ae
252525252525262725252525252627255000000000000000000000000000005105050505050505050505050505050505050505050505050505050505050505050000000000000000000000000000000000000000000000000000000000000000554501010101018111150000000020000428f0b01212120202020a02020202ae
25252526272525252526272525252525500000000000000000000000000000510103010105050505030501010101010103010105050501010105050505050305000000000000000000000000000000000000000000000000000000000000000055454501010121a1a1b1b0108080a08084a8f0b0121212020202020202020aae
25252525252525252525252525252525500000000000000000000000000000510501010505050505050505050505050101010505020505040502020502050105000000000000000000000000000000000000000000000000000000000000000055444010120202222231200000002048486860201252524202020202028292be
25252525252525252525252525252525500000000000000000000000000000510505020505050505010501010505020501050105050501050505050205010505000000000000000000000000000000000000000000000000000000000000000055444000000000000415240000002000002820201240404141010101018190be
171717351415153415151516371717175000000000000000000000000000005105010501050505050105010101050505010505010501050505050505050105050000000000000000000000000000000000000000000000000000000000000000d5c4c040404000000011341010102206062e22220341414140000000008080ae
17173514151515151515151516371717500000000000000000000000000000510505020502050505010505040505050501050101050101050101050505050505000000000000000000000000000000000000000000000000000000000000000055514141416160405011240000002202062e26230341414140000000008080ae
17351415151515341515151515163717500000000000000000000000000000510501050105010505010505050505050501050505050505050101010501050505000000000000000000000000000000000000000000000000000000000000000055404040406160404011240000002202022e27232260606042020200008080ae
351415151515151515151515151516375000000000000000000000000000005105050205050405050105020505050505010505020502050505040505050505050000000000000000000000000000000000000000000000000000000000000000574242424263634242d3a20202023a12131b07060241416143030301018189ab
141515151515153415151515151515165260606060606060606060606060605305050505050505050101050505050505010505050505050505050505050505050000000000000000000000000000000000000000000000000000000000000000f5c0c0c0d0f0f0c0c2d1e1c1c0d0f8d0d1d9d8c4c5c1c0e0c2c2c2c0c0c0c0fa
