252525252525252525252525252525256363636363636363636363636363636305050505050305050505050103010505050501010301010505010101030101010000000000000000000000000000000000000000000000000000000000000000070303070303030b0b07030303030b0303030b0b03030303030303030303030b
252525252526272525252525252627256262626262626262626262626262626205050505050105050505050505050505050505050105050505010505010505010000000000000000000000000000000000000000000000000000000000000000040000000000000808040000000009000000000000000000020202020202020a
25263625252525252525252627252525626262626262626262626262626262620505050505050505050505050505020505050505050505050501050505050501000000000000000000000000000000000000000000000000000000000000000007030202020202020206040400020b02020a0a0b0f070501030303020202060e
252525252525252526272525252525256262626262626262626262626262626205050505050105050505050101010505050505050105050505050205050105050000000000000000000000000000000000000000000000000000000000000000050501010101000000040000000008000008000000000000020202020202060e
25252627252525252525252526272525626262626262626262626262626262620505050205040505050505050405050505050505050502050505050105050505000000000000000000000000000000000000000000000000000000000000000005010101010101010105000000000802020a020202020202020202020202020a
252525252526272525252627252525254261616161616161616161616161614305050505050505050505050505050505050102010501020505050205010102050000000000000000000000000000000000000000000000000000000000000000050101050101010101050000000008000008040406060202020202020202020a
252627252525252525252525252525255000000000000000000000000000005105050505050505050505020505050505050505040505050501050105040505050000000000000000000000000000000000000000000000000000000000000000050101010101010101050000000008000008040406060202020202020202020a
2525252525252627252525252526272550000000000000000000000000000051050505050505050505050505050505050505050505050505050505050505050500000000000000000000000000000000000000000000000000000000000000000501010101010101050500000000080000080c0c06060602020202020202020a
2525252627252525252627252525252550000000000000000000000000000051010301010505050503050101010101010301010505050101010505050505030500000000000000000000000000000000000000000000000000000000000000000501010101010909090d0c04000008000008080806060602020202020202020a
252525252525252525252525252525255000000000000000000000000000005105010105050505050505050505050501010105050205050405020205020501050000000000000000000000000000000000000000000000000000000000000000050000040602020a0a0d0c04000008000008080806060602020202020202060e
252525252525252525252525252525255000000000000000000000000000005105050205050505050105010105050205010501050505010505050502050105050000000000000000000000000000000000000000000000000000000000000000050000000000000000050c04000008000008080806000001010101010101040e
171717351415153415151516371717175000000000000000000000000000005105010501050505050105010101050505010505010501050505050505050105050000000000000000000000000000000000000000000000000000000000000000050000000000000000050c0404040a02020a0a0a03010101000000000000000a
17173514151515151515151516371717500000000000000000000000000000510505020502050505010505040505050501050101050101050101050505050505000000000000000000000000000000000000000000000000000000000000000005050101010908000405080000000a02020a0a0b03010101000000000000000a
17351415151515341515151515163717500000000000000000000000000000510501050105010505010505050505050501050505050505050101010501050505000000000000000000000000000000000000000000000000000000000000000005000000000908000005080000000a02020a0b0b0a080808020202000000000a
35141515151515151515151515151637500000000000000000000000000000510505020505040505010502050505050501050502050205050504050505050505000000000000000000000000000000000000000000000000000000000000000007020202020b0b0202070b0202020e060707030202010109030303010101010b
1415151515151534151515151515151652606060606060606060606060606053050505050505050501010505050505050105050505050505050505050505050500000000000000000000000000000000000000000000000000000000000000000d000000040c0c000205080000040c040505040001010008020202000000000e
