3a00000000000000000000000000000093939393939393939393939393939393010505050505050305010105030501050301010505050101050101030101050500000000000000000000000000000000000000000000000000000000000000000000000000000000000000000000000000000000000000000000000000000000
3828000000000000000000000000000093a0b3b3b3b3b39393b380b3b380b393010501010501050105050502050505050105050505050504050501010105050500000000000000000000000000000000000000000000000000000000000000000000000000000000000000000000000000000000000000000000000000000000
3829000000000000000000000000000093b391b38080b3939380b3a0b3b38093010505010505050505010102010105050105010105010105050205040502050500000000000000000000000000000000000000000000000000000000000000000000000000000000000000000000000000000000000000000000000000000000
3838280000000000000000000000000093b3b3b3b3b3b39393b3b3b3b3b3b393010105010501050105010505040505010105050505050505050502020205050500000000000000000000000000000000000000000000000000000000000000000000000000000000000000000000000000000000000000000000000000000000
38382900000000000000000000000000938282b3b381b39393b3b3b3b3b3b393010105010501050405010505050505050105050105010505050205020502050500000000000000000000000000000000000000000000000000000000000000000000000000000000000000000000000000000000000000000000000000000000
3838382a3a3a3b00000000000000000093b3b3b3b3b3b3939380b3b3b3838193010502050501050505010102010101010105050505050505050205050502050500000000000000000000000000000000000000000000000000000000000000000000000000000000000000000000000000000000000000000000000000000000
383838383838393a3a3a3a3a3a3a3a3a9380b3b38080b39393b380b3b3819193010505050505050505050502050505050105050202020505050502020205050500000000000000000000000000000000000000000000000000000000000000000000000000000000000000000000000000000000000000000000000000000000
3838383838383838383838383838383893939393939393939393939393939393010505050101050505020505050505050105050505050505010502050205010500000000000000000000000000000000000000000000000000000000000000000000000000000000000000000000000000000000000000000000000000000000
3838383838383838383838383838383893939393939393939393939393939393030505050502050501050101030101050305050501010101050505050505050500000000000000000000000000000000000000000000000000000000000000000000000000000000000000000000000000000000000000000000000000000000
0000000000000000000000000000000093b3b3b3b3b3b3939380b3b380b3b393010505010105020501050205050502050505050502050501050505050505050500000000000000000000000000000000000000000000000000000000000000000000000000000000000000000000000000000000000000000000000000000000
0000000000000000000000000000000093b3808280b3b39393b3b3b3b3b3b393050501010502010505050505050505050505050105050205050505010505050500000000000000000000000000000000000000000000000000000000000000000000000000000000000000000000000000000000000000000000000000000000
0000000000000000000000000000000093b3818381b3919393b3b38381b38293050505050502050505050505050505050505010502020505050501020105050500000000000000000000000000000000000000000000000000000000000000000000000000000000000000000000000000000000000000000000000000000000
0000000000000000000000000000000093b3808280b3b3939380b381a0b3b393050501010502010501050105050501050102050205050505050505040505050500000000000000000000000000000000000000000000000000000000000000000000000000000000000000000000000000000000000000000000000000000000
0000000000000000000000000000000093b3b3b3b3b3b39393b3b3b3b3b3b393010505010105020501020102010201020105050205010105050505050505050500000000000000000000000000000000000000000000000000000000000000000000000000000000000000000000000000000000000000000000000000000000
0000000000000000000000000000000093b3b3a0b3b3b39393b3b382b3b39193040505050502050501050505040505050105020505040105050505050505050500000000000000000000000000000000000000000000000000000000000000000000000000000000000000000000000000000000000000000000000000000000
0000000000000000000000000000000093939393939393939393939393939393050505050505050501050505050505050101050505050505050505050505050500000000000000000000000000000000000000000000000000000000000000000000000000000000000000000000000000000000000000000000000000000000
