3a00000000000000000000000000000000000000000000000000000000000000010505050505050305010105030501050301010505050101050101030101050500000000000000000000000000000000000000000000000000000000000000000d0000000008080002050c00000008000505040501000008000002000404040f
382800000000000000000000000000000000000000000000000000000000000001050101050105010505050205050505010505050505050405050101010505050000000000000000000000000000000000000000000000000000000000000000050000000008080003050c00000008000909080c04000008000002000000000b
382900000000000000000000000000000000000000000000000000000000000001050501050505050501010201010505010501010501010505020504050205050000000000000000000000000000000000000000000000000000000000000000050404000001010107050c00000008000101080c04000008000002020000000b
383828000000000000000000000000000000000000000000000000000000000001010501050105010501050504050501010505050505050505050202020505050000000000000000000000000000000000000000000000000000000000000000050000000000000000050c0400000a02010309090504040c0c0802000000000b
3838290000000000000000000000000000000000000000000000000000000000010105010501050405010505050505050105050105010505050205020502050500000000000000000000000000000000000000000000000000000000000000000d0808080000000000050c04000008020102080c04040404040c06040404040f
3838382a3a3a3b00000000000000000000000000000000000000000000000000010502050501050505010102010101010105050505050505050205050502050500000000000000000000000000000000000000000000000000000000000000000703020a08080c0c04050c04040404020102080c04040404040802000000000b
383838383838393a3a3a3a3a3a3a3a3a00000000000000000000000000000000010505050505050505050502050505050105050202020505050502020205050500000000000000000000000000000000000000000000000000000000000000000707020200000008000100000000000201020c0c00000000000002000000000b
3838383838383838383838383838383800000000000000000000000000000000010505050101050505020505050505050105050505050505010502050205010500000000000000000000000000000000000000000000000000000000000000000505000000000008000100000000000001020c0800000000000002000000000b
38383838383838383838383838383838000000000000000000000000000000000305050505020505010501010301010503050505010101010505050505050505000000000000000000000000000000000000000000000000000000000000000005050500000000080808080808080808090a0c0800000000000000000000020b
000000000000000000000000000000000000000000000000000000000000000001050501010502050105020505050205050505050205050105050505050505050000000000000000000000000000000000000000000000000000000000000000050504000000000000000000000000060606040000040404000000000008080b
000000000000000000000000000000000000000000000000000000000000000005050101050201050505050505050505050505010505020505050501050505050000000000000000000000000000000000000000000000000000000000000000050504000000000001010100000000000002000000040404040000000008080b
0000000000000000000000000000000000000000000000000000000000000000050505050502050505050505050505050505010502020505050501020105050500000000000000000000000000000000000000000000000000000000000000000d0d0c040404000000000100000000010103000000040404040000000008080b
000000000000000000000000000000000000000000000000000000000000000005050101050201050105010505050105010205020505050505050504050505050000000000000000000000000000000000000000000000000000000000000000050404040404040404000100000000000003010000040404040000000008080b
000000000000000000000000000000000000000000000000000000000000000001050501010502050102010201020102010505020501010505050505050505050000000000000000000000000000000000000000000000000000000000000000050404040404040404000100000000000002010000040404040000000008080b
0000000000000000000000000000000000000000000000000000000000000000040505050502050501050505040505050105020505040105050505050505050500000000000000000000000000000000000000000000000000000000000000000504040404040404040c08000000020000020101000404040400000000080a0a
0000000000000000000000000000000000000000000000000000000000000000050505050505050501050505050505050101050505050505050505050505050500000000000000000000000000000000000000000000000000000000000000000d0c0c0c0c0c0c0c0c0c0c0c0c0c0e0c0c0e0e0d0d0c0c0c0c0c0c0c0c0c0c0e
